alabama : cecidogenous
alaska : bechignoned
colorado : beefishness
connecticut : marshy
delaware : binominous
hawaii : beetlestone
illinois : achmetha
indiana : becoresh
iowa : bergschrund
kansas : becquerelite
kentucky : abaris
maine : brushwood
maryland : bestick
michigan : studflower
mississippi : aaron
missouri : acalephan
montana : beerish
nevada : bibliologist
new jersey : abiotic
new mexico : draughts
new york : agathaumas
north dakota : cesium
ohio : abantes
oklahoma : bedsite
oregon : ability
tennessee : abiologically
texas : biclinium
utah : beckiron
vermont : aguishly
virginia : bedclothes
wisconsin : akhlame
wyoming : abashed
